Innocence	TacMit	Resist	PhyMit
Zeal	Armour	PhyMit	Morale
Discipline	PhyMit	Resist	Hstat/Might
Fortitude	Resist	Hstat/Might	NCMR
Valour	Hstat/Might	NCMR	Morale
Justice	NCMR	Morale	ICMR
Determination	Morale	ICMR	Hstat/Agility
Tolerance	ICMR	Hstat/Agility	TacMit
Mercy	Hstat/Agility	TacMit	NCPR
Compassion	TacMit	NCPR	PhyMit
Charity	NCPR	PhyMit	Resist
Patience	PhyMit	Resist	ICPR
Wisdom	Resist	ICPR	Hstat/Will
Confidence	ICPR	Hstat/Will	Resist
Idealism	Hstat/Will	Resist	Lstat/Fate
Empathy	Resist	Lstat/Fate	Armour
Honesty	Lstat/Fate	Armour	Power
Loyalty	Armour	Power	Lstat/Vitality
Fidelity	Power	Lstat/Vitality	TacMit
Honour	Lstat/Vitality	TacMit	Resist
